************
*     *   @*
** **   ****
*  *  *    *
*@**  **** *
*  *   @   *
** * *****@*
*       @* *
* * **** * *
* * *@ * * *
*      * *@*
**** *******